NO ./maps/texture/eagle.xpm
SO ./maps/texture/greystone.xpm
EA ./maps/texture/red.xpm
WE ./maps/texture/purplestone.xpm

F 0,0,255
C 0,255,255

1111111111111111111111111
1N00000000000000000000001
1000000000000000000000001
1000000000000000000000001
1000000000000000000000001
1000000000000000000000001
1000000000000000000000001
1000000000000000000000001
1000000000000000000000001
1000000000000000000000001   11111000
1000000000000000000000001
1000000000000000000000001
1111111111111111111111111
